##########
#A     #B#
# ###### #
#        #
##########
